--------------------------------------------------------------------------------
WWWWWWWWWWWWWWWWWWWWWWWWWWWWWWWWWWWWWWWWWWWWWWWWWWWWWWWWWWWWWWWWWWWWWWWWWWWWWWWW
W-------------WWWWWWW-------------WWWWWWW----------------------W------------O--W
W------------W-W-----W-----------W-----W-W--------------------W--O-OO-O---O----W
W-----------W--W--OO--W---------W---O--W--W------------------W-O-O-----O---O---W
W---WWWWWWWW---W-------W-------W--O--O-W---WWWWWWWWW--------W------O-----O-----W
W--W-W-------O-W---O----W-----W----O---W--O----O--W-W------W-O--O----O-----O---W
W-W--W--O------W------O--W---W---O--O--W-----O----W--W----W---O---O----O--O----W
WW---W--O--O---W--O-------W-W--O-------W--O-------W---W--W--O----O----O--------W
W-O--W---------W---OO---O--W-----O--O--W-------O--W----WW----OO--O---O-O----O--W
-O---O--O-O---OO--O---O---OO--O--------O---O------O--O--O--O---O--O-O-----OO--TW
WW-O-W------O--W-----O-----W----OO---O-W------O---W----WW----O-----O---O-------W
W-W--W--O----O-W---O----O-W-W-O----O---W----O-----W---W--W--OO-O--O--O---O--O--W
W--W-W-----O---W-----O---W---W--O------W--O----O--W--W----W---O--------O-------W
W---WW--O----O-W--O-----W-----W---O--O-W-----O----W-W------W-----O--O---O-O----W
W----WWWWWWW---W----O--W-------W-O-----W---WWWWWWWWW--------W-O---O--O-----O---W
W-----------W--W--O---W---------W--O---W--W------------------W--O-------O---O--W
W------------W-W-----W-----------W-----W-W--------------------W---O--O---O-----W
W-------------WWWWWWW-------------WWWWWWW----------------------W----O-----O----W
WWWWWWWWWWWWWWWWWWWWWWWWWWWWWWWWWWWWWWWWWWWWWWWWWWWWWWWWWWWWWWWWWWWWWWWWWWWWWWWW
--------------------------------------------------------------------------------
--------------------------------------------------------------------------------
--------------------------------------------------------------------------------
--------------------------------------------------------------------------------
--------------------------------------------------------------------------------
--------------------------------------------------------------------------------