--------------------------------------------------------------------------------
-------WWWWWWWWWWWWWWWWWWWWWWWWWWWWWWWWWWWWWWWWWWWWWWWWWWWWWWWWWWWWWWWWWWW------
------W------------------------W----------------W------------------------W------
-----W--------------------------W--------------W--------------------------W-----
----W----------------------------W------------W----------------------------W----
---W------------------------------W----------W------------------------------W---
--W--------------------------------WWWWWWWWWW--------------------------------W--
-W----------------------------------W--T---W----------------------------------W-
W------------------------------------W----W------------------------------------W
W-----------------OO------------------WDDW------------------OO-----------------W
W----------------OXXO--------------------------------------OXXO----------------W
W-----------------OO------------------W--W------------------OO-----------------W
W------------------------------------WW--WW------------------------------------W
-W----------------------------------W-W--W-W----------------------------------W-
--W--------------------------------W--W--W--W--------------------------------W--
---W------------------------------W---W--W---W------------------------------W---
----W----------------------------W----W--W----W----------------------------W----
-----W--------------------------W-----W--W-----W--------------------------W-----
------W------------------------W------W--W------W------------------------W------
------WWWWWWWWWWWWWWWWWWWWWWWWWWWWWWWWW--WWWWWWWWWWWWWWWWWWWWWWWWWWWWWWWWW------
--------------------------------------------------------------------------------
--------------------------------------------------------------------------------
--------------------------------------------------------------------------------
--------------------------------------------------------------------------------
--------------------------------------------------------------------------------
--------------------------------------------------------------------------------
--------------------------------------------------------------------------------