--------------------------------------------------------------------------------
WWWWWWWWWWWWWWWWWWWWWWWWWWWWWWWWWWWWWWWWWWWWWWWWWWWWWWWWWWWWWWWWWWWWWWWWWWWWWWWW
W-------------------------------W------t-------W-------------------------------W
W-------------------------------W--------------W-------------------------------W
W-------------------------------W--------------W-------------------------------W
W-------------------------------WWWWWWWOOWWWWWWW-------------------------------W
W----------------------------------W---O----W----------------------------------W
WWWWWWWWW-----------------WWWWWWWWWWWWW--WWWWWWWWWWWWW-----------------WWWWWWWWW
W-------WWWWWWWWWWWWWWWWWWW-----------OOOO-----O-----WWWWWWWWWWWWWWWWWWW---S---W
W-------W---O--O------O---W--------O-----O------O----W---O------O--O---W-------W
Wt------O-O--O--O-O-----O-----O-----O-----------OO-----------O---------O--------
W-------W-----O-OO----O---W------O-----O---O--O---O--W----O------O--O--W-------W
W-------WWWWWWWWWWWWWWWWWWW---------O----------------WWWWWWWWWWWWWWWWWWW-------W
WWWWWWWWW-----------------WWWWWWWWWWWWW--WWWWWWWWWWWWW-----------------WWWWWWWWW
W----------------------------------W--------W----------------------------------W
W-------------------------------WWWWWWWOOWWWWWWW-------------------------------W
W-------------------------------W--------------W-------------------------------W
W-------------------------------W--------------W-------------------------------W
W-------------------------------W-------t------W-------------------------------W
WWWWWWWWWWWWWWWWWWWWWWWWWWWWWWWWWWWWWWWWWWWWWWWWWWWWWWWWWWWWWWWWWWWWWWWWWWWWWWWW
--------------------------------------------------------------------------------
--------------------------------------------------------------------------------
--------------------------------------------------------------------------------
--------------------------------------------------------------------------------
--------------------------------------------------------------------------------
--------------------------------------------------------------------------------