--------------------------------------------------------------------------------
WWWWWWWWWWWWWWWWWWWWWWWWWWWWWWWWWWWWWWW--WWWWWWWWWWWWWWWWWWWWWWWWWWWWWWWWWWWWWWW
W--------W--------W--------W----------W-------W--------W---------W------W------W
W--------W-----------------W------------------W--------W---------W------W------W
W--------W--------W--------W----------WWWWWWWWW--------W---------W------W------W
W--------W--------WWWWWWWWWWWWWWWWWW-WW-------W--------W---------W------W------W
WWWW-WWWWWWW-WWWWWW-------------------WWWWWWW-WWWWWWWWWWWWWWWW-WWWW-WWWWW------W
W--------W-----------------W------------------W--------W--------W-----W--------W
W--------W--------W--------W----------W----------------W--------W-----WWWW--WWWW
WWWWWWWW-WWWWWWW-WWWWWWWWWWWWWWWWWWWWWW-WWWWWWWWWW-WWWWWWWWW-WWWW-----W--------W
W-----------------W---------------------------W--------W--------W--------------D
WWWWW-WWWWWW-WWWWWWWW-WWWWWWWWW-WWWWWWWWWWWWWWW--------W--------W-----W--------W
W--------W--------W--------W--------W---------W-----------------WWW-WWWWWW--WWWW
W--------W--------W--------W------------------W--------W--------W-----W--------W 
W--------W--------W--------W--------W---------WWWW-WWWWW--------------W--------W
WWWW-WWWWWWWWWWWWWWWWWWWW-WWWWWWWWWWWWWWW-WWWWW--------W--------W-----W--------W
W--------W--------W--------W--------W------------------WWWWWWWW-WWW-WWWWWWWWW-WW
W--------W-----------------W--------W---------W--------W--------W-----W--------W
W-----------------W--------W--------W---------W--------W--------W--------------W
WWWWWWWWWWWWWWWWWWWWWWWWWWWWWWWWWWWWWWW--WWWWWWWWWWWWWWWWWWWWWWWWWWWWWWWWWWWWWWW
--------------------------------------------------------------------------------
--------------------------------------------------------------------------------
--------------------------------------------------------------------------------
--------------------------------------------------------------------------------
--------------------------------------------------------------------------------
--------------------------------------------------------------------------------