----------------------------------WWWWW--WWWWW----------------------------------
---------------------WWWWWWWW-----W---------XW-----WWWWWWWW---------------------
---------------------W------W-----WWWW----WWWW-----W------W---------------------
---------------------W------W--------W----W--------W------W---------------------
---------------------WWW--WWW--------W----W--------WWW--WWW---------------------
-----------------------W--W----------W----W----------W--W-----------------------
-----------------------W--W----------W----W----------W--W-----------------------
----WWWWWWWWWW---------W--W-------WWWW----WWWW-------W--W---------WWWWWWWWWW----
WWWWW--------WWWWWWWWWWW--WWWWWWWWW----------WWWWWWWWW--WWWWWWWWWWW-------XWWWWW
--------------------------------------------------------------------------------
WWWWWX-------WWWWWWWWWWW--WWWWWWWWW----------WWWWWWWWW--WWWWWWWWWWW--------WWWWW
----WWWWWWWWWW---------W--W-------WWWW----WWWW-------W--W---------WWWWWWWWWW----
-----------------------W--W----------W----W----------W--W-----------------------
-----------------------W--W----------W----W----------W--W-----------------------
---------------------WWW--WWW--------W----W--------WWW--WWW---------------------
---------------------W------W--------W----W--------W------W---------------------
---------------------W------W------WWW----WWW------W------W---------------------
---------------------WWWWWWWW------W--------W------WWWWWWWW---------------------
-----------------------------------WWWW--WWWW-----------------------------------
--------------------------------------------------------------------------------
--------------------------------------------------------------------------------
--------------------------------------------------------------------------------
--------------------------------------------------------------------------------
--------------------------------------------------------------------------------
--------------------------------------------------------------------------------
--------------------------------------------------------------------------------