--------------------------------------------------------------------------------
WWWWWWWWWWWWWWWWWWWWWWWWWWWWWWWWWWWWWWW--WWWWWWWWWWWWWWWWWWWWWWWWWWWWWWWWWWWWWWW
W-----------W-W--W----WWWW------W-----W---P---P-----P--P----P-----P-----P--P---W
W-WWWWWWWW----W-----W----W--WWW-W---W-WWW---P----P-------P----P-P---P-P------P-W
W-W------WWWW-W-WWWWWWW-WW--W---WWW-W-WWWW-----P------P----P-------P----P---P--W
W-----WW---W-----W----------W-------W----W-P-P---P--P---P---P-P--P---P----P----W
WWWWWWWWWW-WWWWWWWWWWWWWWWWWWWWWWWWWWWWW-WWWWWWWWWWWWWWWWWWWWWWWWWW-WWWWWWWWWWWW
W-----------------------------W------------------W-----------------------------W
W---P---P---P---P---P---P---P-W------------------W---P---P---P---P---P---P---P-W
W-----------------------------W------------------W-----------------------------W
W---------------------------M-W------------------------------------------------D
W-----------------------------W------------------W-----------------------------W
W---P---P---P---P---P---P---P-W------------------W---P---P---P---P---P---P---P-W
W-----------------------------W------------------W-----------------------------W
WWWWWWWWWWOWWWWWWWWWWWWWWWWWWWWWWWW-WWWW-WWWWWWWWWWWWWWWWWWWWWWWWWWWWWWWWWWWWWWW
W-----O--O--O----W--O---O-O----O--O---W-------W-------------WWW--------WWW-----W
W---O--O-----O---W-O--O---O--O--O-----WWWWWWW----WWWWWWWWW--------WWW-------WWWW
W----O--O-O-O-O-OO--O----O------O---O-WWW---WWWWWWWW-----WWWWWWWWW---WWW-WWWWWWW
W--O---O----O----W-----O----O-----O---W---W----------WWW-----------W-----------W
WWWWWWWWWWWWWWWWWWWWWWWWWWWWWWWWWWWWWWW--WWWWWWWWWWWWWWWWWWWWWWWWWWWWWWWWWWWWWWW
--------------------------------------------------------------------------------
--------------------------------------------------------------------------------
--------------------------------------------------------------------------------
--------------------------------------------------------------------------------
--------------------------------------------------------------------------------
--------------------------------------------------------------------------------