WWWWWWWWWWWWWWWWWWWWWWWWWWWWWWWWWWWWWWW--WWWWWWWWWWWWWWWWWWWWWWWWWWWWWWWWWWWWWWW
W------------------WW--------------------------------------WW------------------W
W------------------------------------------------------------------------------W
W------------------WW------------------WW------------------WW------------------W
WWWWWWWWW--WWWWWWWWWWWWWWWWWW--WWWWWWWWWWWWWWWWWW--WWWWWWWWWWWWWWWWWW--WWWWWWWWW
W------------------WW------------------WW------------------WW------------------W
W------------------------------------------------------------------------------W
W------------------WW------------------WW------------------WW------------------W
WWWWWWWWW--WWWWWWWWWWWWWWWWWWWWWWWWWWWWWWWWWWWWWW--WWWWWWWWWWWWWWWWWW--WWWWWWWWW
W------------------WW------------------WW------------------WW------------------W
WWWWWWWWW--WWWWWWWWWWWWWWWWWW--WWWWWWWWWWWWWWWWWW--WWWWWWWWWWWWWWWWWW--WWWWWWWWW
W------------------WW------------------WW------------------WW------------------W
W------------------------------------------------------------------------------W
W------------------WW------------------WW------------------WW------------------W
WWWWWWWWW--WWWWWWWWWWWWWWWWWW--WWWWWWWWWWWWWWWWWW--WWWWWWWWWWWWWWWWWW--WWWWWWWWW
W------------------WW------------------WW------------------WW------------------W
W------------------------------------------------------------------------------W
W--------T---------WW---------T--------WW---------T--------WW---------T--------W
WWWWWWWWWWWWWWWWWWWWWWWWWWWWWWWWWWWWWWWWWWWWWWWWWWWWWWWWWWWWWWWWWWWWWWWWWWWWWWWW
--------------------------------------------------------------------------------
--------------------------------------------------------------------------------
--------------------------------------------------------------------------------
--------------------------------------------------------------------------------
--------------------------------------------------------------------------------
--------------------------------------------------------------------------------