--------------------------------------------------------------------------------
WWWWWWWWWWWWWWWWWWWWWWWWWWWWWWWWWWWWWWW--WWWWWWWWWWWWWWWWWWWWWWWWWWWWWWWWWWWWWWW
W-----------W-W--W----WWWW------W-----W---P---P-----P--P----P-----P-----P--P---W
W-WWWWWWWW----W-----W----W--WWW-W---W-WWW---P----P-------P----P-P---P-P------P-W
W-W------WWWW-W-WWWWWWW-WW--W---WWW-W-WWWW-----P------P----P-------P----P---P--W
W-----WW---W-----W----------W-------W----W-P-P---P--P---P---P-P--P---P----P----W
WWWWWWWWWW-WWWWWWWWWWWWWWWWWWWWWWWWWWWWW-WWWWWWWWWWWWWWWWWWWWWWWWWW-WWWWWWWWWWWW
W-----------------------------W------------------W-----------------------------W
W---P---P---P---P---P---P---P-W------------------W---P---P---P---P---P---P---P-W
W-----------------------------W------------------W-----------------------------W
W---------------------------M-W------------------------------------------------D
W-----------------------------W------------------W-----------------------------W
W---P---P---P---P---P---P---P-W------------------W---P---P---P---P---P---P---P-W
W-----------------------------W------------------W-----------------------------W
WWWWWWWWWW-WWWWWWWWWWWWWWWWWWWWWWWW-WWWW-WWWWWWWWWWWWWWWWWWWWWWWWWWWWWWWWWWWWWWW
W----------------W--------------------W-------W-------------WWW--------WWW-----W
W----------------W--------------------WWWWWWW----WWWWWWWWW--------WWW-------WWWW
W-------------------------------------WWW---WWWWWWWW-----WWWWWWWWW---WWW-WWWWWWW
W----------------W--------------------W---W----------WWW-----------W-----------W
WWWWWWWWWWWWWWWWWWWWWWWWWWWWWWWWWWWWWWW--WWWWWWWWWWWWWWWWWWWWWWWWWWWWWWWWWWWWWWW
--------------------------------------------------------------------------------
--------------------------------------------------------------------------------
--------------------------------------------------------------------------------
--------------------------------------------------------------------------------
--------------------------------------------------------------------------------
--------------------------------------------------------------------------------