--------------------------------------------------------------------------------
WWWWWWWWWWWWWWWWWWWWWWWWWWWWWWWWWWWWWWWWWWWWWWWWWWWWWWWWWWWWWWWWWWWWWWWWWWWWWWWW
W-------------------------------W------T-------W-------------------------------W
W-------------------------------W--------------W-------------------------------W
W-------------------------------W--------------W-------------------------------W
W-------------------------------WWWWWWWOOWWWWWWW-------------------------------W
W----------------------------------W---O----W----------------------------------W
WWWWWWWWW-----------------WWWWWWWWWWWWW--WWWWWWWWWWWWW-----------------WWWWWWWWW
W-------WWWWWWWWWWWWWWWWWWW-----------OOOO-----O-----WWWWWWWWWWWWWWWWWWW-------W
W-------W---O--O------O---W--------O-----O------O----W---O------O--O---W-------W
WT------O-O--O--O-O-----O-----O-----O-----------OO-----------O---------O--------
W-------W-----O-OO----O---W------O-----O---O--O---O--W----O------O--O--W-------W
W-------WWWWWWWWWWWWWWWWWWW---------O----------------WWWWWWWWWWWWWWWWWWW-------W
WWWWWWWWW-----------------WWWWWWWWWWWWW--WWWWWWWWWWWWW-----------------WWWWWWWWW
W----------------------------------W--------W----------------------------------W
W-------------------------------WWWWWWWOOWWWWWWW-------------------------------W
W-------------------------------W--------------W-------------------------------W
W-------------------------------W--------------W-------------------------------W
W-------------------------------W-------T------W-------------------------------W
WWWWWWWWWWWWWWWWWWWWWWWWWWWWWWWWWWWWWWWWWWWWWWWWWWWWWWWWWWWWWWWWWWWWWWWWWWWWWWWW
--------------------------------------------------------------------------------
--------------------------------------------------------------------------------
--------------------------------------------------------------------------------
--------------------------------------------------------------------------------
--------------------------------------------------------------------------------
--------------------------------------------------------------------------------