--------------------------------------------------------------------------------
WWWWWWWWWWWWWWWWWWWWWWWWWWWWWWWWWWWWWWW--WWWWWWWWWWWWWWWWWWWWWWWWWWWWWWWWWWWWWWW
W------------------------------------------------------------------------------W
W------------------------------------------------------------------------------W
W----PPP------PPP------PPP--------PPP------PPP--------PPP------PPP------PPP----W
W----PPP------PPP------PPP--------PPP------PPP--------PPP------PPP------PPP----W
W------------------------------------------------------------------------------W
W------------------------------------------------------------------------------W
W----PPP-----------------------------------------------------------------PPP---W
W----PPP-----------------------------------------------------------------PPP---W
W------------------------------------------------------------------------------W
W----PPP-----------------------------------------------------------------PPP---W 
W----PPP-----------------------------------------------------------------PPP---W
W------------------------------------------------------------------------------W
W------------------------------------------------------------------------------W
W----PPP------PPP------PPP------PPP--------PPP-------PPP--------PPP------PPP---W
W----PPP------PPP------PPP------PPP--------PPP-------PPP--------PPP------PPP---W
W------------------------------------------------------------------------------W
W--------------------------------------T---------------------------------------W
WWWWWWWWWWWWWWWWWWWWWWWWWWWWWWWWWWWWWWWWWWWWWWWWWWWWWWWWWWWWWWWWWWWWWWWWWWWWWWWW
--------------------------------------------------------------------------------
--------------------------------------------------------------------------------
--------------------------------------------------------------------------------
--------------------------------------------------------------------------------
--------------------------------------------------------------------------------
--------------------------------------------------------------------------------