--------------------------------------------------------------------------------
WWWWWWWWWWWWWWWWWWWWWWWWWWWWWWWWWWWWWWWWWWWWWWWWWWWWWWWWWWWWWWWWWWWWWWWWWWWWWWWW
W------OOOOOO-OOOOOOOOOOOOOOOOOOOOO-OOOOOOOOOOOOOOOOOOOOOO-OOOOOOOOOOOOOO------W
W------------------O-------------------------O---------O-----------------------W
W------------------------------------------------------------------------------W
WWWWWWWWW--WWWWWWWWWWWWWWW---WWWWWWWWWWWWWWWWWWWWWWWWWWWWWWWWWWWWWWWWWWWWWWWWWWW
W----------------------------OOOO-OOOOOOOOOOOOOOOOOOO-OOOOOOOOOOOOOOOOOOO-OOOOOW
W-------------------O-------------------------O---------------------------O----W
W------------------------------------------------------------------------------W
WWWWWWWWW--WWWWWWWWWWWWWWWWWWWWWWWWWWWWWWWWWWWWWW--WWWWWWWWWWWWWWWWWWWWWWWWWWWWW
-------------------WW------------------WW----------GGG------------------------TW
WWWWWWWWW--WWWWWWWWWWWWWWWWWW--WWWWWWWWWWWWWWWWWW--WWWWWWWWWWWWWWWWWWWWWWWWWWWWW
W------------------------------------------------------------------------------W
W--------O---------------------------O-------------------------------------O---W
W------------------------------OOOOOOOOOO-OOOOOOOOOO-OOOOOOOOOOOOOOOOOOOOOO-OOOW
WWWWWWWWW--WWWWWWWWWWWWWWWWWW--WWWWWWWWWWWWWWWWWWWWWWWWWWWWWWWWWWWWWWWWWWWWWWWWW
W------------------------------------------------------------------------------W
W------OOOOOOOOOOOOOOOOOOOOOOOOOOOOOOOOOOOOOOOOOOOOOOOOOOOOOOOOOOOOOOOOOO------W
WWWWWWWWWWWWWWWWWWWWWWWWWWWWWWWWWWWWWWWWWWWWWWWWWWWWWWWWWWWWWWWWWWWWWWWWWWWWWWWW
--------------------------------------------------------------------------------
--------------------------------------------------------------------------------
--------------------------------------------------------------------------------
--------------------------------------------------------------------------------
--------------------------------------------------------------------------------
--------------------------------------------------------------------------------