--------------------------------------------------------------------------------
WWWWWWWWWWWWWWWWWWWWWWWWWWWWWWWWWWWWWWWWWWWWWWWWWWWWWWWWWWWWWWWWWWWWWWWWWWWWWWWW
W------------------WW-----OO------O----WW-----O----O-------WW------------------W
W------------------WWT---O---O----OO---O----O--O--O----------------------------W
W------------------WW----------O----O--WW---O-----OO-O-----WW--------O---------W
WWWWWWWWW--WWWWWWWWWWWWWWWWWWWWWWWWWWWWWWWWWWWWWWWWWWWWWWWWWWWWWWWWWW--WWWWWWWWW
W------------------WW------------------WW-----O------O-----WW------------------W
W--------O-----------------------------WW---O-----O----O---O-------------------W
W-------OOOO-------WW------------------WW-----O-OO---------WW------------------W
WWWWWWWWW--WWWWWWWWWWWWWWWWWWWWWWWWWWWWWWWWWWWWWW--WWWWWWWWWWWWWWWWWWWWWWWWWWWWW
--------O----------WW------------------WW------------------O-------------------W
WWWWWWWWW--WWWWWWWWWWWWWWWWWW--WWWWWWWWWWWWWWWWWW--WWWWWWWWWWWWWWWWWWOOWWWWWWWWW
W-------OOOO-------WW------------------WW-------OO---------WW-----O-----O------W
W-----O---O--------WW--------O--------------O-O------------WW--------O----O----W
W--------O---------WW------------------WW---------O--------WW---------O-O------W
WWWWWWWWW--WWWWWWWWWWWWWWWWWW--WWWWWWWWWWWWWWWWWWWWWWWWWWWWWWWWWWWWWWO-WWWWWWWWW
W------------O-----WW-------OO---------WW-------O-------O--WW-----O----O-------W
W---------O----O----O-----O----O-------WW---------O--O---O-------O--O---O------W
W---------------O--WW------------------WW------O---O----OO-WW---------O--------W
WWWWWWWWWWWWWWWWWWWWWWWWWWWWWWWWWWWWWWWWWWWWWWWWWWWWWWWWWWWWWWWWWWWWWWWWWWWWWWWW
--------------------------------------------------------------------------------
--------------------------------------------------------------------------------
--------------------------------------------------------------------------------
--------------------------------------------------------------------------------
--------------------------------------------------------------------------------
--------------------------------------------------------------------------------