----------------------------------WWWWW--WWWWW----------------------------------
---------------------WWWWWWWW-----W----------W-----WWWWWWWW---------------------
---------------------W---T--W-----WWWW----WWWW-----W--T---W---------------------
---------------------W------W--------W----W--------W------W---------------------
---------------------WWW--WWW--------W----W--------WWW--WWW---------------------
-----------------------W--W----------W----W----------W--W-----------------------
-----------------------W--W----------W----W----------W--W-----------------------
----WWWWWWWWWW---------W--W-------WWWW----WWWW-------W--W---------WWWWWWWWWW----
WWWWW--------WWWWWWWWWWW--WWWWWWWWW----------WWWWWWWWW--WWWWWWWWWWW--------WWWWW
--------------------------------------------------------------------------------
WWWWW--------WWWWWWWWWWW--WWWWWWWWW----------WWWWWWWWW--WWWWWWWWWWW--------WWWWW
----WWWWWWWWWW---------W--W-------WWWW----WWWW-------W--W---------WWWWWWWWWW----
-----------------------W--W----------W----W----------W--W-----------------------
-----------------------W--W----------W----W----------W--W-----------------------
---------------------WWW--WWW--------W----W--------WWW--WWW---------------------
---------------------W------W--------W----W--------W------W---------------------
---------------------W---T--W------WWW----WWW------W--T---W---------------------
---------------------WWWWWWWW------W--------W------WWWWWWWW---------------------
-----------------------------------WWWW--WWWW-----------------------------------
--------------------------------------------------------------------------------
--------------------------------------------------------------------------------
--------------------------------------------------------------------------------
--------------------------------------------------------------------------------
--------------------------------------------------------------------------------
--------------------------------------------------------------------------------
--------------------------------------------------------------------------------