--------------------------------------------------------------------------------
WWWWWWWWWWWWWWWWWWWWWWWWWWWWWWWWWWWWWWWWWWWWWWWWWWWWWWWWWWWWWWWWWWWWWWWWWWWWWWWW
W------------------WW------------------WW------------------WW------------------W
W------------------WWT---------------------------------------------------------W
W------------------WW------------------WW------------------WW------------------W
WWWWWWWWW--WWWWWWWWWWWWWWWWWWWWWWWWWWWWWWWWWWWWWWWWWWWWWWWWWWWWWWWWWW--WWWWWWWWW
W------------------WW------------------WW------------------WW------------------W
W--------------------------------------WW--------------------------------------W
W------------------WW------------------WW------------------WW------------------W
WWWWWWWWW--WWWWWWWWWWWWWWWWWWWWWWWWWWWWWWWWWWWWWW--WWWWWWWWWWWWWWWWWWWWWWWWWWWWW
-------------------WW------------------WW--------------------------------------W
WWWWWWWWW--WWWWWWWWWWWWWWWWWW--WWWWWWWWWWWWWWWWWW--WWWWWWWWWWWWWWWWWW--WWWWWWWWW
W------------------WW------------------WW------------------WW------------------W
W------------------WW--------------------------------------WW------------------W
W------------------WW------------------WW------------------WW------------------W
WWWWWWWWW--WWWWWWWWWWWWWWWWWW--WWWWWWWWWWWWWWWWWWWWWWWWWWWWWWWWWWWWWW--WWWWWWWWW
W------------------WW------------------WW------------------WW------------------W
W--------------------------------------WW--------------------------------------W
W------------------WW------------------WW------------------WW------------------W
WWWWWWWWWWWWWWWWWWWWWWWWWWWWWWWWWWWWWWWWWWWWWWWWWWWWWWWWWWWWWWWWWWWWWWWWWWWWWWWW
--------------------------------------------------------------------------------
--------------------------------------------------------------------------------
--------------------------------------------------------------------------------
--------------------------------------------------------------------------------
--------------------------------------------------------------------------------
--------------------------------------------------------------------------------