--------------------------------------------------------------------------------
WWWWWWWWWWWWWWWWWWWWWWWWWWWWWWWWWWWWWWWWWWWWWWWWWWWWWWWWWWWWWWWWWWWWWWWWWWWWWWWW
W------------------------------------------W----T-----W-------------------------
W------------------------------------------W----------W-------------------------
W-------------WWWW-------------------------WWWW----WWWW-------------------------
W----------WWW----WWW---WWWWWWW---------------W----W----------------------------
W---------WW--------WW--W------W----WWWWWWWWWWW----WWWWWWWWW--------------------
W--------WW----------WW-W------W---W-----------------------W--------------------
W-------WW------------WWW------WW-W------------------------W------------WWWWWWW-
WWWWWWWWW---------------W--------W-------------------------WWWWWWWWWWWWWW-----WW
WT------------------------------------------------------------------------------
WWWWWWWWW---------------W--------W-------------------------WWWWWWWWWWWWWW-----WW
W-------WW------------WW-------WW-W------------------------W------------WWWWWWW-
W--------WW----------W-W-------W---W-----------------------W-------------------
W---------WW---------W--W------W----WWWWWWWWWWW----WWWWWWWWW--------------------
W----------WWW----WWW---WWWWWWW---------------W----W----------------------------
W-------------WWWW-------------------------WWWW----WWWW-------------------------
W------------------------------------------W----------W-------------------------
W------------------------------------------W----T-----W-------------------------
WWWWWWWWWWWWWWWWWWWWWWWWWWWWWWWWWWWWWWWWWWWWWWWWWWWWWWWWWWWWWWWWWWWWWWWWWWWWWWWW
--------------------------------------------------------------------------------
--------------------------------------------------------------------------------
--------------------------------------------------------------------------------
--------------------------------------------------------------------------------
--------------------------------------------------------------------------------
--------------------------------------------------------------------------------