-------WWWWWWWWWWWWWWWWWWWWWWWW------------------WWWWWWWWWWWWWWWWWWWWWWWW-------
------W------------------------W----------------W------------------------W------
-----W--------------------------W--------------W--------------------------W-----
----W----------------------------W------------W----------------------------W----
---W------------------------------W----------W------------------------------W---
--W--------------------------------WWWWWWWWWW--------------------------------W--
-W----------------------------------W------W----------------------------------W-
W------------------------------------W----W------------------------------------W
W-------------------------------------WDDW-------------------------------------W
W------------------------------------------------------------------------------W
W-------------------------------------W--W-------------------------------------W
W------------------------------------WW--WW------------------------------------W
-W----------------------------------W-W--W-W----------------------------------W-
--W--------------------------------W--W--W--W--------------------------------W--
---W------------------------------W---W--W---W------------------------------W---
----W----------------------------W----W--W----W----------------------------W----
-----W--------------------------W-----W--W-----W--------------------------W-----
------W------------------------W------W--W------W------------------------W------
-------WWWWWWWWWWWWWWWWWWWWWWWW-------W--W-------WWWWWWWWWWWWWWWWWWWWWWWW-------
--------------------------------------------------------------------------------
--------------------------------------------------------------------------------
--------------------------------------------------------------------------------
--------------------------------------------------------------------------------
--------------------------------------------------------------------------------
--------------------------------------------------------------------------------
--------------------------------------------------------------------------------