--------------------------------------------------------------------------------
WWWWWWWWWWWWWWWWWWWWWWWWWWWWWWWWWWWWWWW--WWWWWWWWWWWWWWWWWWWWWWWWWWWWWWWWWWWWWWW
W--------W--------W--------W----------W-------W--------W---------W------W------W
W--------W-----------------W----------O-------W--------W---------W------W------W
W--------W--------W--------W----------WWWWWWWWW--------W---------W------W------W
W--------W--------WWWWWWWWWWWWWWWWWWOWW-------W--------W---------W------W------W
WWWW-WWWWWWW-WWWWWW--------O----------WWWWWWW-WWWWWWWWWWWWWWWW-WWWW-WWWWW------W
W--------W-----------------W------------------W--------W--------W-----W--------W
W--------W--------W--------W----------W----------------W--------W-----WWWWO-WWWW
WWWWWWWW-WWWWWWWOWWWWWWWWWWWWWWWWWWWWWW-WWWWWWWWWWOWWWWWWWWW-WWWW----OW---OO---W
W-------O---------W--------O------------------W--------W--------W----OO--------D
WWWWW-WWWWWW-WWWWWWWW-WWWWWWWWW-WWWWWWWWWWWWWWW--------W--------W----OW--------W
W--------W--------W----O---W--------W---------W--------O--------WWW-WWWWWW--WWWW
W--------W--------W--OO----W------------------W--------W--------W-----W--------W 
W--------W--------W-----O--W--------W---------WWWW-WWWWW--------O-----W--------W
WWWW-WWWWWWWWWWWWWWWWWWWW-WWWWWWWWWWWWWWW-WWWWW--------W--------W-----W--------W
W--------W--------W--------W--------W-----O------------WWWWWWWW-WWW-WWWWWWWWW-WW
W--------W------------O----W--------W-----OOOOW--------W--------W-----W--------W
W--------O--------W--------W--------W---------W--------W--------W--------------W
WWWWWWWWWWWWWWWWWWWWWWWWWWWWWWWWWWWWWWW--WWWWWWWWWWWWWWWWWWWWWWWWWWWWWWWWWWWWWWW
--------------------------------------------------------------------------------
--------------------------------------------------------------------------------
--------------------------------------------------------------------------------
--------------------------------------------------------------------------------
--------------------------------------------------------------------------------
--------------------------------------------------------------------------------