--------------------------------------------------------------------------------
-------WWWWWWWWWWWWWWWWWWWWWWWWWWWWWWWWWWWWWWWWWWWWWWWWWWWWWWWWWWWWWWWWWWW------
------W------------------------W----------------W------------------------W------
-----W-------------O------------W--------------W--------------------------W-----
----W----------------------------W------------W----------------------------W----
---W----O-------------------------W----------W------------------------------W---
--W--------------------------------WWWWWWWWWW--------------------------------W--
-W-------------------------O--------W--T---W----------------------------------W-
W------------------------------------W----W------------------------------------W
W-------------------------------------WDDW------------------OO-----------------W
W------O----------XX----------S----------------------------OXXO----------------W
W-------------------------------------W--W------------------OO-----------------W
W------------------------------------WW--WW------------------------------------W
-W----------------------------------W-W--W-W----------------------------------W-
--W--------------------------------W--W--W--W--------------------------------W--
---W-------O----------------------W---W--W---W------------------------------W---
----W----------------------------W----W--W----W----------------------------W----
-----W-------------------O------W-----W--W-----W--------------------------W-----
------W------------------------W------W--W------W------------------------W------
------WWWWWWWWWWWWWWWWWWWWWWWWWWWWWWWWW--WWWWWWWWWWWWWWWWWWWWWWWWWWWWWWWWW------
--------------------------------------------------------------------------------
--------------------------------------------------------------------------------
--------------------------------------------------------------------------------
--------------------------------------------------------------------------------
--------------------------------------------------------------------------------
--------------------------------------------------------------------------------
--------------------------------------------------------------------------------