WWWWWWWWWWWWWWWWWWWWWWWWWWWWWWWWWWWWWWW--WWWWWWWWWWWWWWWWWWWWWWWWWWWWWWWWWWWWWWW
W-------------------------------------W--W-------------------------------------W
W-------------------------------------W--W-------------------------------------W
W-------------------------------------W--W-------------------------------------W
W-------------------------------------W--W-------------------------------------W
W-------------------------------------W--W-------------------------------------W
W----------WWWWWWWW-------------------W--W-------------------WWWWWWWW----------W
W----------W------W-------------------W--W-------------------W------W----------W
WWWWWWWWWWWW------WWWWWWWWWWWWWWWWWWWWW--WWWWWWWWWWWWWWWWWWWWW-----XWWWWWWWWWWWW
--------------------------------------------------------------------------------
WWWWWWWWWWWWX-----WWWWWWWWWWWWWWWWWWWWW--WWWWWWWWWWWWWWWWWWWWW------WWWWWWWWWWWW
W----------W------W-------------------W--W-------------------W------W----------W
W----------WWWWWWWW-------------------W--W-------------------WWWWWWWW----------W
W---------------------------------WWWWW--WWWWW---------------------------------W
W---------------------------------W----------W---------------------------------W
W---------------------------------W------X---W---------------------------------W
W---------------------------------WWWWW--WWWWW---------------------------------W
W-------------------------------------W--W-------------------------------------W
WWWWWWWWWWWWWWWWWWWWWWWWWWWWWWWWWWWWWWW--WWWWWWWWWWWWWWWWWWWWWWWWWWWWWWWWWWWWWWW
--------------------------------------------------------------------------------
--------------------------------------------------------------------------------
--------------------------------------------------------------------------------
--------------------------------------------------------------------------------
--------------------------------------------------------------------------------
--------------------------------------------------------------------------------