--------------------------------------------------------------------------------
WWWWWWWWWWWWWWWWWWWWWWWWWWWWWWWWWWWWWWWWWWWWWWWWWWWWWWWWWWWWWWWWWWWWWWWWWWWWWWWW
W-------------WWWWWWW-------------WWWWWWW----------------------W---------------W
W------------W-W-----W-----------W-----W-W--------------------W----------------W
W-----------W--W------W---------W------W--W------------------W-----------------W
W---WWWWWWWW---W-------W-------W-------W---WWWWWWWWW--------W------------------W
W--W-W---------W--------W-----W--------W----------W-W------W-------------------W
W-W--W---------W---------W---W---------W----------W--W----W--------------------W
WW---W---------W----------W-W----------W----------W---W--W---------------------W
W----W---------W-----------W-----------W----------W----WW----------------------W
------------------------------------------------------------------------------TW
WW---W---------W-----------W-----------W----------W----WW----------------------W
W-W--W---------W----------W-W----------W----------W---W--W---------------------W
W--W-W---------W---------W---W---------W----------W--W----W--------------------W
W---WW---------W--------W-----W--------W----------W-W------W-------------------W
W----WWWWWWW---W-------W-------W-------W---WWWWWWWWW--------W------------------W
W-----------W--W------W---------W------W--W------------------W-----------------W
W------------W-W-----W-----------W-----W-W--------------------W----------------W
W-------------WWWWWWW-------------WWWWWWW----------------------W---------------W
WWWWWWWWWWWWWWWWWWWWWWWWWWWWWWWWWWWWWWWWWWWWWWWWWWWWWWWWWWWWWWWWWWWWWWWWWWWWWWWW
--------------------------------------------------------------------------------
--------------------------------------------------------------------------------
--------------------------------------------------------------------------------
--------------------------------------------------------------------------------
--------------------------------------------------------------------------------
--------------------------------------------------------------------------------