--------------------------------------------------------------------------------
WWWWWWWWWWWWWWWWWWWWWWWWWWWWWWWWWWWWWWWWWWWWWWWWWWWWWWWWWWWWWWWWWWWWWWWWWWWWWWWW
W-------------------------------W------T-------W-------------------------------W
W-------------------------------W--------------W-------------------------------W
W-------------------------------W--------------W-------------------------------W
W-------------------------------WWWWWWW--WWWWWWW-------------------------------W
W----------------------------------W--------W----------------------------------W
WWWWWWWWW-----------------WWWWWWWWWWWWW--WWWWWWWWWWWWW-----------------WWWWWWWWW
W-------WWWWWWWWWWWWWWWWWWW--------------------------WWWWWWWWWWWWWWWWWWW-------W
W-------W-----------------W--------------------------W-----------------W-------W
WT------------------------------------------------------------------------------
W-------W-----------------W--------------------------W-----------------W-------W
W-------WWWWWWWWWWWWWWWWWWW--------------------------WWWWWWWWWWWWWWWWWWW-------W
WWWWWWWWW-----------------WWWWWWWWWWWWW--WWWWWWWWWWWWW-----------------WWWWWWWWW
W----------------------------------W--------W----------------------------------W
W-------------------------------WWWWWWW--WWWWWWW-------------------------------W
W-------------------------------W--------------W-------------------------------W
W-------------------------------W--------------W-------------------------------W
W-------------------------------W-------T------W-------------------------------W
WWWWWWWWWWWWWWWWWWWWWWWWWWWWWWWWWWWWWWWWWWWWWWWWWWWWWWWWWWWWWWWWWWWWWWWWWWWWWWWW
--------------------------------------------------------------------------------
--------------------------------------------------------------------------------
--------------------------------------------------------------------------------
--------------------------------------------------------------------------------
--------------------------------------------------------------------------------
--------------------------------------------------------------------------------