--------------------------------------------------------------------------------
WWWWWWWWWWWWWWWWWWWWWWWWWWWWWWWWWWWWWWWWWWWWWWWWWWWWWWWWWWWWWWWWWWWWWWWWWWWWWWWW
W------------------------------------------W----T-----W-------------------------
W------------------------------------------W----------W-------------------------
W-------------WWWW-------------------------WWWW----WWWW-------------------------
W----------WWW----WWW---WWWWWWW---------------W----W----------------------------
W---------WW--------WW--W------W----WWWWWWWWWWW----WWWWWWWWW--------------------
W--------WW--O---O---WW-W--O---W---W----O-----O-O-OO-------W--------------------
W-------WW----------O-WWW-O--O-WW-W---O----O---OOOO---------W------------WWWWWWW-
WWWWWWWWW-----O---O-----W---O----W---O----O-------O-O--O---WWWWWWWWWWWWWW-----WW
WT-------O-------O--O-O---O---O--O-----O-----O--O---O---O--O--------------------
WWWWWWWWW----O----------W--O-----W--------O----O--O---O--O-WWWWWWWWWWWWWW-----WW
W-------WW------O--O--WW-----O-WW-W----O------------O---O--W------------WWWWWWW-
W--------WW----------W-W---O---W---W-------O--OOOOOO-------W-------------------
W---------WW---O-----W--W------W----WWWWWWWWWWW-O-OWWWWWWWWW--------------------
W----------WWW----WWW---WWWWWWW---------------W----W----------------------------
W-------------WWWW-------------------------WWWW----WWWW-------------------------
W------------------------------------------W----------W-------------------------
W------------------------------------------W----T-----W-------------------------
WWWWWWWWWWWWWWWWWWWWWWWWWWWWWWWWWWWWWWWWWWWWWWWWWWWWWWWWWWWWWWWWWWWWWWWWWWWWWWWW
--------------------------------------------------------------------------------
--------------------------------------------------------------------------------
--------------------------------------------------------------------------------
--------------------------------------------------------------------------------
--------------------------------------------------------------------------------
--------------------------------------------------------------------------------