WWWWWWWWWWWWWWWWWWWWWWWWWWWWWWWWWWWWWWWWWWWWWWWWWWWWWWWWWWWWWWWWWWWWWWWWWWWWWWWW
W------------------------------------W-T--W------------------------------------W
W-----------WWWWWWWWWWWWWWWWWWWWWWWWWW----WWWWWWWWWWWWWWWWWWWWWWWWWW-----------W
W-----------W------------------------------------------------------W-----------W
W-----------W--WWWWWWWWWWWWWWWWWWWWWWW----WWWWWWWWWWWWWWWWWWWWWWW--W-----------W
W-----------W--W---------------------W----W---------------------W--W-----------W
W-----------W--W---------------------W----W---------------------W--W-----------W
W-----------W--W--------------------W------W--------------------W--W-----------W
W-------WWWWW--WWWWW---------------W--------W---------------WWWWW--WWWWW-------W
W-------W----------W--------------W----------W--------------W----------W-------W
W-------WT---------W-------------W------------W-------------W---------TW-------W
W-------W----------W--------------W----------W--------------W----------W-------W
W-------WWWWW--WWWWW---------------W--------W---------------WWWWW--WWWWW-------W
W-----------W--W--------------------W------W--------------------W--W-----------W
W-----------W--W---------------------W----W---------------------W--W-----------W
W-----------W--W---------------------W----W---------------------W--W-----------W
W-----------W--WWWWWWWWWWWWWWWWWWWWWWW----WWWWWWWWWWWWWWWWWWWWWWW--W-----------W
W-----------W------------------------------------------------------W-----------W
WWWWWWWWWWWWWWWWWWWWWWWWWWWWWWWWWWWWWWW--WWWWWWWWWWWWWWWWWWWWWWWWWWWWWWWWWWWWWWW
--------------------------------------------------------------------------------
--------------------------------------------------------------------------------
--------------------------------------------------------------------------------
--------------------------------------------------------------------------------
--------------------------------------------------------------------------------
--------------------------------------------------------------------------------
--------------------------------------------------------------------------------